R 1408 768
NO ./path_to_the_north_texture
SO ./path_to_the_south_texture
WE ./path_to_the_west_texture
EA ./path_to_the_east_texture
S ./path_to_the_sprite_texture
F 0,108,2
C 0,30,110

1 1 1 1 1 1 1 1 1 1 1 1 1 1 1 1 1 1 1 1 1 1 
1 0 0 0 0 0 0 0 0 0 0 0 0 0 0 0 0 0 0 0 0 1 
1 0 0 0 0 0 0 0 0 0 0 0 0 0 0 0 0 0 0 0 0 1 
1 0 0 0 0 0 0 0 0 0 0 0 0 W 0 0 0 0 0 0 0 1 
1 0 0 0 0 0 0 0 0 0 0 0 0 0 0 0 0 0 0 0 01 
1 0 0 0 0 0 0 0 0 0 0 0 0 0 0 0 0 0 0 0 01 
1 0 0 0 0 0 0 0 0 0 0 0 0 0 0 0 0 0 0 0 01 
1 0 0 0 1 0 0 0 0 0 0 0 0 0 0 0 0 0 0 0 01 
1 0 0 0 0 1 0 0 0 0 0 0 0 0 0 0 0 0 0 0 01
1 0 0 0 0 0 1 0 1 0 0 1 0 0 0 0 0 0 0 0 01
1 0 0 0 0 0 0 0 0 0 0 0 0 0 0 0 0 0 0 0 01
1 1 1 1 1 1 1 1 1 1 1 1 1 1 1 1 1 1 1 1 11

